a stamp - отметка(печать)
Hereby - таким образом
assets - активы, ресурсы
to leverage - использовать
to maintain - поддерживать, сохранять
a/to mediate - посредник/посредничать
to transmit - передавать, транслировать
robust - крепкий, устойчивый
to churn - взбивать, взбалтывать
frequent - частый, постоянный
Likewise - точно так же 
to establish - устанавливать, утверждать, учреждать
degree - степень
Beyond - вне, по ту сторону
inception - зарождение, начало
censorship - цензура
Hence - следовательно
intention - намерение, стремление
malicious - злонамеренный
fraud - мошенничество, обман
to pend - ожидать
to discard - отбрасывать
renown - известный
meticulous - тщательный, дотошный
orphan - сирота
to abandon - отказываться, бросать, оставлять
stale - чёрствый, несвежий
performance - производительность
extinct - вымерший, угасший
revenue - доход
In a nutshell - в двух словах
to undermine - подрывать, разрушать
to recoup - окупиться, компенсировать
yield - урожай, доходность
indeed - действительно, в самом деле
to grasp - понять, осознать, усвоить
to elect - избирать, выбирать
a spreadsheet - электронная таблица
to facilitate - способствовать, содействовать
clunky - неуклюжий
to prompt - подсказка, напоминание (быстрый, незамедлительный)
to dedicate - выделить
a backbone - хребет, позвоночник, основа
overlap - совпадение
to coerce - принуждать, заставлять